R     1501       1500
NO        ../texture/pink_stained_glass.xpm
SO       ../texture/pink_stained_glass.xpm
WE      ../texture/pink_stained_glass.xpm
EA       ../texture/pink_stained_glass.xpm
S                      ../texture/lpigeon.xpm
F      255,190,200
C        255,210,180

            1111111111111111111111111
            100000000110000000000201
            10110000011100N000002020111
            110010000000000000002000200111111111
1111111111110110000001120020000020000011
10000000001100000111011111111111111111
11110111111111011100000010011  1111
11110111111111011101010010001  101
11000000110101011N0000001000111111
1000100000000001100000010001
10000000000000001101010010001
1100000111010100111101111000111
11110111 1100101 101111010001
11111111 1111111111111111111