R     1500       1000
NO        ./path_to_the_north_texture
SO       ./path_to_the_south_texture
WE      ./path_to_the_west_texture
EA       ./path_to_the_east_texture
S                      ./path_to_the_sprite_texture
F      220,255,255
C        255,0,0

        1111111111111111111111111
        1200000000110000000000001
        0011000001110000002000001
       01001000000000000000000001
110000001111011000001110000000000001
10000000001100000111011111111101101
111101111111110111000000122210
11110111111111011101010010001
11000000110101011100000010000
10001000000000001100000010001
1000N000000000001101010010000
0100000111010100011101111000111
11110111 1110101 101111010001
11111111 11111110111111111111
