R     1200       1000
NO        ../texture/pink_stained_glass.xpm
SO       ../texture/pink_stained_glass.xpm
WE      ../texture/pink_stained_glass.xpm
EA       ../texture/pink_stained_glass.xpm
S                      ../texture/lpigeon.xpm
F      255,190,200
C        255,210,180

11111111111111111111111111111
120000000000000N0000000000021
11111111111112021111111111111
12000000000000000000000000021
11111111111112021111111111111
12000000000000000000000000021
11111111111112021111111111111
12000000000000000000000000021
11111111111112021111111111111
12000000000000000000000000021
11111111111112021111111111111
12000000000000000000000000021
11111111111112021111111111111
12000000000000000000000000021
11111111111112021111111111111
12000000000000000000000000021
11111111111112021111111111111
10000000000000200000000000001
11111111111111111111111111111

