R     2500       2000
NO        ./path_to_the_north_texture
SO       ./path_to_the_south_texture
WE      ./path_to_the_west_texture
EA       ./path_to_the_east_texture
S                      ./path_to_the_sprite_texture
F      220,255,255
C        255,0,0


11000000111101100000111000000
10000000001100000111011111111
11110111111111011100000012221
11110111111111011101010010001
11000000110101011100000010000
10000000000000001100000010001
1000N000000000001101010010000
01000001110101000111011110001
11110111 1110101 101111010001
11111111 11111110111111111111
