R     901       800
NO        ../texture/lime_stained_glass.xpm
SO       ../texture/magenta_stained_glass.xpm
WE      ../texture/orange_stained_glass.xpm
EA       ../texture/pink_stained_glass.xpm
S                      ../texture/barrel.xpm
F      220,255,255
C        255,0,0

        1111111111111111111111111
        1000000000110000000000001
        0011000001110000000000001
       010010000000000000N00002001
1100000011110110000001110000000000101
10000000001100000111011111111101101
11110111111111011100000010010
11110111111111011101010010001
11000000110101011100000010000
10001000000000001100000010001
1000N000000000001101010010000
0100000111010100011101111000111
11110111 1110101 101111010001
11111111 11111110111111111111
