R 10000 10000
NO ./texture/lime_stained_glass.xpm

SO ./texture/magenta_stained_glass.xpm

WE ./texture/pink_stained_glass.xpm

EA ./texture/orange_stained_glass.xpm

S ./texture/lpigeon.xpm

F 255,190,200

C 255,210,180

1111111111111111111111111
1000000000110000200000201
1011000001110200002000001
1001000000002N000200002011111111111
111111111011000001110000002000001
100000000011001001110111111111111
1111011111111101110000010001
11110111111111011101010010001
11000000110101011100000010001
10002000000000001100000010001
10000000000000001101010010001
1100000111010101111101111000111
11110111 1110101    101111010001
11111111 1111111    111111111111